00000000000
01111B11110
01111111110
01111111110
01111111110
01111111110
01111111110
01111111110
01111111110
01111E11110
00000000000
