0000000000000
0111111111110
011111B111110
0111111111110
0111111111110
0100000011110
0111100001000
0111111111010
0100000000010
011111E111110
0111111111110
0000000000000
