0000000000000
0111111111110
011111B111110
0111111111110
0111111111110
0111100011110
0111100011110
0111111111110
0111111111110
011111E111110
0111111111110
0000000000000
