00000000000
01011111010
01011111010
01011B11010
01011111010
01011111010
01000000010
01111111110
01111E11110
01111111110
00000000000
